Indo-European	Bhil, Dom, Gujarati, Khandesi, Punjabi, Marwari, Romani, Hindi, Urdu, Bundeli, Bengali, Bihari, Maithili, Oriya, Nepali, Garwhali, Kumauni, Kashmiri, Kohistani, Kunar, Shina, Lahnda, Sindhi, Sinhalese, Konkani, Marathi, Sanskrit, Osetin, Pamir languages, Pashto, Baluchi, Kurdish languages, Ormuri-Parachi, Semnani, Talysh, Zaza-Gorani, Fars, Luri, Persian, Tajiki, Attic, Doric, Latin, Romanian,Emiliano-Romagnolo, Friulan, Dalmatian, Istriot, Italian, Neapolitan-Calabrese, Sicilian, Venetian, Ligurian, Lombard, French, Franco-Provençal, Piemontese, Rheto-Romance languages, Aragonese, Asturian, Extremaduran, Spanish, Catalan, Gascon, Languedocien, Galician, Portuguese, Mozarabic, Corsican, Sardinian, Breton, Cornwall, Welsh, Irish Gaelic, Scots Gaelic, Isle of Man, Gothic, Danish, Swedish, Norwegian, Faroese, Icelandic, Bavarian, German, Luxembourghish, Schwytzertütsch, Walser, Yiddish, Afrikaans, Dutch, Flemish, Saxon, English, Frisian, Latvian, Lithuanian, Belorussian, Russian, Ukrainian, Bulgarian, Macedonian, Bosnian, Serbian, Croatian, Slovenian, Czech, Slovak, Polish, Gheg Albanian, Tosk Albanian, Arvanitika, Arberëshë, Armenian, Sylheti, Serbo-Croatian, Bhojpuri, Chittagonian, Assamese, Kurdish, Saraiki, Awadhi, Balochi, Odia (Oriya), Haitian Creole, Deccan, Greek, Haryanvi, Magahi, Dhundhari, Chhattisgarhi
Uralic	Estonian, Finnish, Karelian, Lappic, Hungarian, Samoyedic languages
Basque	Basque
Afro-Asiatic	Aramaic, Arabic, Canaanite Hebrew, Samaritan, Geez, Tigré, Gafat, Amharic, Harari, South Arabian languages, Kabyle, Zenati, Tamasheq, Zenaga, Dullay, Sidamo, Komso, Oromo, Afar, Somali, Coptic, Dizi, Gonga, Ometo, Mao, Biu-Mandara, Masa, Hausa, Bole, Tangale, Angas, Yivom, Fyer, Ron, Bade, Duwai, Boghom, Guruntum, Zaar
Niger-Kordofanian	Kadugli, Heiban, Katla, Rashad, Mambila-Konja, Bebe, Jarawan, Mamfe, Mbam, Mbe, Bantu, Kikuyu-Kamba, Sukuma-Nyamwezi, Tongwe, Shambala,Tanzania, Swahili, Zigula-Zaramo, Zulu, Xhosa, Sotho, Pedi, Shona, Herero, Kongo, Duala, Lingala, Kimbundu, Umbundo, Edo, Idoma, Igbo, Kainji, Nupe, Oko, Dogon, Kru, Kwa, Gur, Kulango, Lobi, Senufo, Teen, Tiefo, Tusia, Viemo, Wara-Natioro, Mossi, Yoruba, Kirundi, Kinyarwanda, Fula, Chewa, Akan
Nilo-Saharan	Lendu, Mangbetu, Mangbutu-Efe, Moru-Madi, Bongo-Bagirmi, Eastern Jebel, Nara, Nubian, Surmic, Bari, Maasai, Lotuxo, Teso, Turkana, Kalenjin, Tatoga, Dinka, Nuer, Shilluk, Maban, Burun, Saharan
Altaic	Ainu, Chagatay, Uzbek, Uyghur, Yugur, Altai, Dolgan, Karagas, Khakas, Shor, Tuvin, Yakut, Azerbaijani, Turkish, Turkmenian, Kazakh, Kirghiz, Tatar, Dagur, Mongour, Buriat, Mongolian, Darkhat, Kalmyk, Turkmen
Korean	Korean
Japanese	Japanese, Ryukyuan
Sino-Tibetan	Gan Chinese, Gan, Hakka, Huizhou, Jinyu, Mandarin, Min Bei, Min Dong, Min Nan, Min Zhong, Pu-Xian, Wu, Xiang, Yue, Dungan, Kachinic, Bodo, Garo, Konyak, Wu (inc. Shanghainese), Lushai, Chin, Naga , Bodic, Tibetan, Himalayish languages, Newari, Karen , Lolo, Qiang, Yue (Cantonese), Southern Min, Burmese, Jin, Xiang (Hunnanese), Eastern Min
Daic	Kadai, Kam-Sui, Tai, Thai, Zhuang
Austro-Asiatic	Mon-Khmer, Munda, Malaysian/Indonesian, Vietnamese
Austronesian	Formosan, Western Malayo-Polinesian, Central Eastern Malayo-Polinesian, South Halmahera-West New Guinea, Javanese, sundanese, Tagalog, Madurese, Malagasy, Cebuano (Visayan), Ilocano
Andamanese	Languages of the Andaman Islands in the gulf of Bengala
Australian	Pama-Nyungan languages, Non-Pama-Nyungan
Eskimo-Aleut	11 languages spoken by peoples living on the arctic and subarctic coast of continental America and the extreme strip of North Eastern Siberia: Aleut, Inuit, Yupik
Na-Dene	Languages spoken by native peoples of Canada and some peoples of  South Western United States: Kiowa Apache, Navajo Apache, Mescalero Chiricahua, Beaver Sekani, Chipewyan, Koyukon, Mattole Wailaki, Tolowa Galice, Tahltan Kaska, Tanana, Tutchone, Eyak, Tlingit
Amerindian	Cree, Ojibwa, Chippewa, Arapaho, Blackfoot, Cheyenne, Wiyot, Yurok, Alakaluf, Arawak, Aymara, Cofan, Garifuna, Guarani, Jivaro, Ona, Pasto, Quechua, Siriono, Tariana, Tucano languages, Tupi-Guarani languages, Wanano, Yaghan, Pawnee, Wichita,  Aruak, Chibcha, Tunebo, Cofan Guaymi, Kuna, Motilon, Paya, Rama, Talamanca, Esselen, Yuman, Karok-Shasta, Pomo, Yana, Salinan-Seri, Tequistatlecan, Washo, Mohawk, Oneida, Seneca, Onondaga, Huron, Tuscarora, Cherokee, Susquehannock, Bororo, Botocudo, Chiquito, Fulnio, Ge-Kaingang, Guato, Kamakan, Karaja, Maxacali, Opaye, Puri, Rikbaktsa, Yabuti, Oti, Cholan, Tzeltalan, Huastecan, Chujean, Kanjobalan, Mocho, Ixilan, Mamean, Kekchi, Pocom, Quichean, Sacapulteco, Sipacapeno, Uspantec, Mopan-Itza, Yucatec-Lacandon, Mixe, Zoque,  Muskogee, Choktaw, Chickasaw, Amuzgoan, Chiapanec-Mangue, Chinantecan, Cuitatec, Mixtec, Trique, Chichimec, Matlatzincan, Mazaua, Otomi, Pame, Chocho, Popolocan, Ixcatecan, Mazatecan, Chatino, Zapotec, Chinookan, Maiduan, Coosan, Siuslawan, Yakonan, Kalapuyan, Takelma, Klamath-Modoc, Sahaptin, Tsimshian, Utian, Yokuts, Halkomelem, Nooksack, Squamish, Straits, Twana, Tillamook, Tsamosan, Catawaba, Mandan, Chiwere, Dakota, Dhegiha, Winnebago, Crow, Hidatsa, Biloxi, Ofo, Tutelo, Hopi, Comanche, Panamint, Shoshoni, Ute, Paiute, Nahuatl, Cahita, Corachol, Tarahumaran, Tepiman, Tubar, Nootka
Caucasian	Georgian, Svan, Laz, Mingrelian, Batsi, Chechen-Ingush, Andi, Avar, Dido, Lak-Dargwa, Lezgian, Abkhaz-Abazin, Circassian, Ubix
Dravidian	 Kolami-Naiki, Parji-Gadaba, Gondi, Konda, Manda-Kui, Telugu, Kannada, Kodagu, Malayalam, Tamil, Toda-Kota, Tulu
